11111111111111111111
10000000000000000001
10000000001000000001
10000000000000000001
10000000001111111001
10000000000000001001
10000000111000001001
10000000001000001001
10000000001000001001
10010000001111101001
10000000000000101001
10001000000000101001
10000000000000101001
10000000001111101001
10000000001000001001
10000000001000001001
10000000001000001001
10000000001111111001
11111111111111111111
