1111111111111111111111111111111111111111111111111111111111111111111111111111111111111111111111111111
1000000000000000000000000000000000000000000000000000000000000000000000000000000000000000000000000001
1000000000000000000000000000000000000000000000000000000000000000000000000000000000000000000000000001
1000000000000000000000000000000000000000000000000000000000000000000000000000000000000000000000000001
1000000000000000000000000000000000011101000000000000000000000000000000000000000000000000000000000001
1000000000000000000000000000000000000000000000000000000000000000000000000000000000000000000000000001
1000000000000000000000000000000000000000000000000000000000000000000000000000000000000000000000000001
1000000000000000000000000000000000111100000000000000000000000000000000000000000000000000000000000001
1000000000000000000000000000000000000000000000000000000000000000000000000000000000000000000000000001
1000000000000000000101000000000000000000000000000000000000000000000000000000000000000000000000000001
1000000000000000000101000000000000000000000000000000000000000000000000000000000000000000000000000001
1000000000000000000101000000000011111100000000000000000000000000000000000000000000000000000000000001
1000000000000000000101000000000000000000000000000000000000000000000000000000000000000000000000000001
1000000000000000000101000000000000000000000000000000000000000000000000000000000000000000000000000001
1000000000000000000101000000000000000000000000000000000000000000000000000000000000000000000000000001
1000000000000000000101111111111111111111111111111111111111111111100000000000000000000000000000000001
1000000000000000001100000000000000000000000000000000000000000000100000000000000000000000000000000001
1000000000000000001111111111111111111111111111111111111111111100100000000000000000000000000000000001
1000000000000000000000000000000000000000000000000000000000000100100000000000000000000000000000000001
1000000000000000000000000000000000000000000000000000000000000100100000000000000000000000000000000001
1000000000000000000000000000000000000000000000000000000000001100100000000000000000000000000000000001
1000000000000000000000000000000000000000000000000000000000011000111111111110000000000000000000000001
1000000000000000000000000000000000000000000000000000000000011000000000000010000000000000000000000001
1000000000000000000000000000000000000000000000000000000000011111111111111010000000000000000000000001
1000000000000000000000000000000000000000000000000000000000000000000000001010000000000000000000000001
1000000000000000000000000000000000000000000000000000000000000000000000001s10000000000000000000000001
1000000000000000000000000000000000000000000000000000000000000000000000001110000000000000000000000001
1000000000000000000000000000000000000000000000000000000000000000000000000000000000000000000000000001
1000000000000000000000000000000000000000000000000000000000000000000000000000000000000000000000000001
1111111111111111111111111111111111111111111111111111111111111111111111111111111111111111111111111111
