1111111111111111111111111111111111111111111111111111111111111111111111111
1000011100000000000000000000000000000000000000000000000000000000000000001
1000000011111111111100000000000000000000000000000000000000000000000000001
1000010000000000000100000000000000011101000000000000000000000000000000001
1000011111111111110100000000000000000000000000000000000000000000000000001
1000000000000000010100000000000000000000000000000000000000000000000000001
1000000000000000010100000000000000000000000000000000000000000000000000001
1000000000000000010100000000000000000000000000000000000000000000000000001
1000000000000000010100000000000000000000000000000000000000000000000000001
1000000000000000010111111111110000000000000000000000000000000000000000001
1000000000000000010000000000s10000000000000000000000000000000000000000001
1000000000000000011111111111110000000000000000000000000000000000000000001
1000000000000000000000000000000000000000000000000000000000000000000000001
1000000000000000000000000000000000000000000000000000000000000000000000001
1000000000000000000000000000000000000000000000000000000000000000000000001
1000000000000000000000000000000000000000000000000000000000000000000000001
1111111111111111111111111111111111111111111111111111111111111111111111111
